{
  "width": 32,
  "height": 32,
  "tiles": [
    [7, 2, 2,  2,  2, 2, 2, 2, 2,  2, 2,  2,  2, 2, 2, 2, 2, 2, 2, 2, 2, 2, 2, 2,  2, 2, 2, 2,  2, 2,  2, 8],
    [4, 3, 3, 3, 3, 3, 3, 3, 3, 3, 3,  3,  3, 3, 3, 3, 3, 3, 3, 3, 3, 3, 3, 3,  3, 3, 3, 3,  3, 3,  3, 4],
    [4, 1, 1,  1,  1,  1,  1,  1,  1,  1,  1,  1,  1, 1, 1,  1,  1, 1, 1, 1,  1,  1,  1,  1,  1, 1,  1, 1,  1, 1,  1, 4],
    [4, 1, 1,  1,  1,  1,  1,  1,  1,  1,  1,  1,  1, 1, 1,  1,  1, 1, 1, 1,  1,  1,  1,  1,  1, 1,  1, 1,  1, 1,  1, 4],
    [4, 1, 1,  1,  1,  1,  1,  1,  1,  1,  1,  1,  1, 1, 1,  1,  1, 1, 1, 1,  1,  1,  1,  1,  1, 1,  1, 1,  1, 1,  1, 4],
    [4, 1, 1,  1,  1,  1,  1,  1,  1,  1,  1,  1,  1, 1, 1,  1,  1, 1, 1, 1,  1,  1,  1,  1,  1, 1,  1, 1,  1, 1,  1, 4],
    [4, 1, 1,  1,  1,  1,  1,  1,  1,  1,  1,  1,  1, 1, 1,  1,  1, 1, 1, 1,  1,  1,  1,  1,  1, 1,  1, 1,  1, 1,  1, 4],
    [4, 1, 1,  1,  1,  1,  1,  1,  1,  1,  1,  1,  1, 1, 1,  1,  1, 1, 1, 1,  1,  1,  1,  1,  1, 1,  1, 1,  1, 1,  1, 4],
    [4, 1, 1,  1,  1,  1,  1,  1,  1,  1,  1,  1,  1, 1, 1,  1,  1, 1, 1, 1,  1,  1,  1,  1,  1, 1,  1, 1,  1, 1,  1, 4],
    [4, 1, 1,  1,  1,  1,  1,  1,  1,  1,  1,  1,  1, 1, 1,  1,  1, 1, 1, 1,  1,  1,  1,  1,  1, 1,  1, 1,  1, 1,  1, 4],
    [4, 1, 1,  1,  1,  1,  1,  1,  1,  1,  1,  1,  1, 1, 1,  1,  1, 1, 1, 1,  1,  1,  1,  1,  1, 1,  1, 1,  1, 1,  1, 4],
    [4, 1, 1,  1,  1,  1,  1,  1,  1,  1,  1,  1,  1, 1, 1,  1,  1, 1, 1, 1,  1,  1,  1,  1,  1, 1,  1, 1,  1, 1,  1, 4],
    [4, 1, 1,  1,  1,  1,  1,  1,  1,  1,  1,  1,  1, 1, 1,  1,  1, 1, 1, 1,  1,  1,  1,  1,  1, 1,  1, 1,  1, 1,  1, 4],
    [4, 1, 1,  1,  1,  1,  1,  1,  1,  1,  1,  1,  1, 1, 1,  1,  1, 1, 1, 1,  1,  1,  1,  1,  1, 1,  1, 1,  1, 1,  1, 4],
    [4, 1, 1,  1,  1,  1,  1,  1,  1,  1,  1,  1,  1, 1, 1,  1,  1, 1, 1, 1,  1,  1,  1,  1,  1, 1,  1, 1,  1, 1,  1, 4],
    [4, 1, 1,  1,  1,  1,  1,  1,  1,  1,  1,  1,  1, 1, 1,  1,  1, 1, 1, 1,  1,  1,  1,  1,  1, 1,  1, 1,  1, 1,  1, 4],
    [4, 1, 1,  1,  1,  1,  1,  1,  1,  1,  1,  1,  1, 1, 1,  1,  1, 1, 1, 1,  1,  1,  1,  1,  1, 1,  1, 1,  1, 1,  1, 4],
    [4, 1, 1,  1,  1,  1,  1,  1,  1,  1,  1,  1,  1, 1, 1,  1,  1, 1, 1, 1,  1,  1,  1,  1,  1, 1,  1, 1,  1, 1,  1, 4],
    [4, 1, 1,  1,  1,  1,  1,  1,  1,  1,  1,  1,  1, 1, 1,  1,  1, 1, 1, 1,  1,  1,  1,  1,  1, 1,  1, 1,  1, 1,  1, 4],
    [4, 1, 1,  1,  1,  1,  1,  1,  1,  1,  1,  1,  1, 1, 1,  1,  1, 1, 1, 1,  1,  1,  1,  1,  1, 1,  1, 1,  1, 1,  1, 4],
    [4, 1, 1,  1,  1,  1,  1,  1,  1,  1,  1,  1,  1, 1, 1,  1,  1, 1, 1, 1,  1,  1,  1,  1,  1, 1,  1, 1,  1, 1,  1, 4],
    [4, 1, 1,  1,  1,  1,  1,  1,  1,  1,  1,  1,  1, 1, 1,  1,  1, 1, 1, 1,  1,  1,  1,  1,  1, 1,  1, 1,  1, 1,  1, 4],
    [4, 1, 1,  1,  1,  1,  1,  1,  1,  1,  1,  1,  1, 1, 1,  1,  1, 1, 1, 1,  1,  1,  1,  1,  1, 1,  1, 1,  1, 1,  1, 4],
    [4, 1, 1,  1,  1,  1,  1,  1,  1,  1,  1,  1,  1, 1, 1,  1,  1, 1, 1, 1,  1,  1,  1,  1,  1, 1,  1, 1,  1, 1,  1, 4],
    [4, 1, 1,  1,  1,  1,  1,  1,  1,  1,  1,  1,  1, 1, 1,  1,  1, 1, 1, 1,  1,  1,  1,  1,  1, 1,  1, 1,  1, 1,  1, 4],
    [4, 1, 1,  1,  1,  1,  1,  1,  1,  1,  1,  1,  1, 1, 1,  1,  1, 1, 1, 1,  1,  1,  1,  1,  1, 1,  1, 1,  1, 1,  1, 4],
    [4, 1, 1,  1,  1,  1,  1,  1,  1,  1,  1,  1,  1, 1, 1,  1,  1, 1, 1, 1,  1,  1,  1,  1,  1, 1,  1, 1,  1, 1,  1, 4],
    [4, 1, 1,  1,  1,  1,  1,  1,  1,  1,  1,  1,  1, 1, 1,  1,  1, 1, 1, 1,  1,  1,  1,  1,  1, 1,  1, 1,  1, 1,  1, 4],
    [4, 1, 1,  1,  1,  1,  1,  1,  1,  1,  1,  1,  1, 1, 1,  1,  1, 1, 1, 1,  1,  1,  1,  1,  1, 1,  1, 1,  1, 1,  1, 4],
    [4, 1, 1,  1,  1,  1,  1,  1,  1,  1,  1,  1,  1, 1, 1,  1,  1, 1, 1, 1,  1,  1,  1,  1,  1, 1,  1, 1,  1, 1,  1, 4],
    [4, 1, 1,  1,  1,  1,  1,  1,  1,  1,  1,  1,  1, 1, 1,  1,  1, 1, 1, 1,  1,  1,  1,  1,  1, 1,  1, 1,  1, 1,  1, 4],
    [5, 2, 2,  2,  2,  2,  2,  2,  2,  2,  2,  2, 25, 2, 2,  2,  2, 2, 2, 2,  2,  2,  2,  2,  2, 2,  2, 2,  2, 2,  2, 4]
  ],
  "foreground": [
    [0, 0, 0, 0, 0, 0, 0, 0, 0, 0, 0, 0, 0, 0, 0, 0, 0, 0, 0, 0, 0, 0, 0, 0, 0, 0, 0, 0, 0, 0, 0, 0],
    [0, 0, 0, 0, 0, 0, 0, 0, 0, 0, 0, 0, 0, 0, 0, 0, 0, 0, 0, 0, 0, 0, 0, 0, 0, 0, 0, 0, 0, 0, 0, 0],
    [0, 0, 0, 0, 0, 0, 0, 0, 0, 0, 0, 0, 0, 0, 0, 0, 0, 0, 0, 0, 0, 0, 0, 0, 0, 0, 0, 0, 0, 0, 0, 0],
    [0, 0, 0, 0, 0, 0, 0, 0, 0, 0, 0, 0, 0, 0, 0, 0, 0, 0, 0, 0, 0, 0, 0, 0, 0, 0, 0, 0, 0, 0, 0, 0],
    [0, 0, 0, 0, 0, 0, 0, 0, 0, 0, 0, 0, 0, 0, 0, 0, 0, 0, 0, 0, 0, 0, 0, 0, 0, 0, 0, 0, 0, 0, 0, 0],
    [0, 0, 0, 0, 0, 0, 0, 0, 0, 0, 0, 0, 0, 0, 0, 0, 0, 0, 0, 0, 0, 0, 0, 0, 0, 0, 0, 0, 0, 0, 0, 0],
    [0, 0, 0, 0, 0, 0, 0, 0, 0, 0, 0, 0, 0, 0, 0, 0, 0, 0, 0, 0, 0, 0, 0, 0, 0, 0, 0, 0, 0, 0, 0, 0],
    [0, 0, 0, 0, 0, 0, 0, 0, 0, 0, 0, 0, 0, 0, 0, 0, 0, 0, 0, 0, 0, 0, 0, 0, 0, 0, 0, 0, 0, 0, 0, 0],
    [0, 0, 0, 0, 0, 0, 0, 0, 0, 0, 0, 0, 0, 0, 0, 0, 0, 0, 0, 0, 0, 0, 0, 0, 0, 0, 0, 0, 0, 0, 0, 0],
    [0, 0, 0, 0, 0, 0, 0, 0, 0, 0, 0, 0, 0, 0, 0, 0, 0, 0, 0, 0, 0, 0, 0, 0, 0, 0, 0, 0, 0, 0, 0, 0],
    [0, 0, 0, 0, 0, 0, 0, 0, 0, 0, 0, 0, 0, 0, 0, 0, 0, 0, 0, 0, 0, 0, 0, 0, 0, 0, 0, 0, 0, 0, 0, 0],
    [0, 0, 0, 0, 0, 0, 0, 0, 0, 0, 0, 0, 0, 0, 0, 0, 0, 0, 0, 0, 0, 0, 0, 0, 0, 0, 0, 0, 0, 0, 0, 0],
    [0, 0, 0, 0, 0, 0, 0, 0, 0, 0, 0, 0, 0, 0, 0, 0, 0, 0, 0, 0, 0, 0, 0, 0, 0, 0, 0, 0, 0, 0, 0, 0],
    [0, 0, 0, 0, 0, 0, 0, 0, 0, 0, 0, 0, 0, 0, 0, 0, 0, 0, 0, 0, 0, 0, 0, 0, 0, 0, 0, 0, 0, 0, 0, 0],
    [0, 0, 0, 0, 0, 0, 0, 0, 0, 0, 0, 0, 0, 0, 0, 0, 0, 0, 0, 0, 0, 0, 0, 0, 0, 0, 0, 0, 0, 0, 0, 0],
    [0, 0, 0, 0, 0, 0, 0, 0, 0, 0, 0, 0, 0, 0, 0, 0, 0, 0, 0, 0, 0, 0, 0, 0, 0, 0, 0, 0, 0, 0, 0, 0],
    [0, 0, 0, 0, 0, 0, 0, 0, 0, 0, 0, 0, 0, 0, 0, 0, 0, 0, 0, 0, 0, 0, 0, 0, 0, 0, 0, 0, 0, 0, 0, 0],
    [0, 0, 0, 0, 0, 0, 0, 0, 0, 0, 0, 0, 0, 0, 0, 0, 0, 0, 0, 0, 0, 0, 0, 0, 0, 0, 0, 0, 0, 0, 0, 0],
    [0, 0, 0, 0, 0, 0, 0, 0, 0, 0, 0, 0, 0, 0, 0, 0, 0, 0, 0, 0, 0, 0, 0, 0, 0, 0, 0, 0, 0, 0, 0, 0],
    [0, 0, 0, 0, 0, 0, 0, 0, 0, 0, 0, 0, 0, 0, 0, 0, 0, 0, 0, 0, 0, 0, 0, 0, 0, 0, 0, 0, 0, 0, 0, 0],
    [0, 0, 0, 0, 0, 0, 0, 0, 0, 0, 0, 0, 0, 0, 0, 0, 0, 0, 0, 0, 0, 0, 0, 0, 0, 0, 0, 0, 0, 0, 0, 0],
    [0, 0, 0, 0, 0, 0, 0, 0, 0, 0, 0, 0, 0, 0, 0, 0, 0, 0, 0, 0, 0, 0, 0, 0, 0, 0, 0, 0, 0, 0, 0, 0],
    [0, 0, 0, 0, 0, 0, 0, 0, 0, 0, 0, 0, 0, 0, 0, 0, 0, 0, 0, 0, 0, 0, 0, 0, 0, 0, 0, 0, 0, 0, 0, 0],
    [0, 0, 0, 0, 0, 0, 0, 0, 0, 0, 0, 0, 0, 0, 0, 0, 0, 0, 0, 0, 0, 0, 0, 0, 0, 0, 0, 0, 0, 0, 0, 0],
    [0, 0, 0, 0, 0, 0, 0, 0, 0, 0, 0, 0, 0, 0, 0, 0, 0, 0, 0, 0, 0, 0, 0, 0, 0, 0, 0, 0, 0, 0, 0, 0],
    [0, 0, 0, 0, 0, 0, 0, 0, 0, 0, 0, 0, 0, 0, 0, 0, 0, 0, 0, 0, 0, 0, 0, 0, 0, 0, 0, 0, 0, 0, 0, 0],
    [0, 0, 0, 0, 0, 0, 0, 0, 0, 0, 0, 0, 0, 0, 0, 0, 0, 0, 0, 0, 0, 0, 0, 0, 0, 0, 0, 0, 0, 0, 0, 0],
    [0, 0, 0, 0, 0, 0, 0, 0, 0, 0, 0, 0, 0, 0, 0, 0, 0, 0, 0, 0, 0, 0, 0, 0, 0, 0, 0, 0, 0, 0, 0, 0],
    [0, 0, 0, 0, 0, 0, 0, 0, 0, 0, 0, 0, 0, 0, 0, 0, 0, 0, 0, 0, 0, 0, 0, 0, 0, 0, 0, 0, 0, 0, 0, 0],
    [0, 0, 0, 0, 0, 0, 0, 0, 0, 0, 0, 0, 0, 0, 0, 0, 0, 0, 0, 0, 0, 0, 0, 0, 0, 0, 0, 0, 0, 0, 0, 0],
    [0, 0, 0, 0, 0, 0, 0, 0, 0, 0, 0, 0, 0, 0, 0, 0, 0, 0, 0, 0, 0, 0, 0, 0, 0, 0, 0, 0, 0, 0, 0, 0],
    [0, 0, 0, 0, 0, 0, 0, 0, 0, 0, 0, 0, 0, 0, 0, 0, 0, 0, 0, 0, 0, 0, 0, 0, 0, 0, 0, 0, 0, 0, 0, 0]
  ],
  "enemies": [
    {
      "x": 100,
      "y": 200,
      "speed": 1.5,
      "minX": 50,
      "maxX": 200
    },
    {
      "x": 350,
      "y": 800,
      "speed": 1.5,
      "minX": 300,
      "maxX": 400
    },
    {
      "x": 550,
      "y": 1500,
      "speed": 3.5,
      "minX": 500,
      "maxX": 650
    },
    {
      "x": 900,
      "y": 1200,
      "speed": 6.5,
      "minX": 900,
      "maxX": 1100
    }
  ]
}