{
  "width": 32,
  "height": 32,
  "tiles": [
    [7, 2, 2,  2,  2, 2, 2, 2, 2,  2,  2,  2,  2, 2, 2, 4, 2, 2, 2, 2, 2, 2, 2, 2,  2, 2, 2, 2,  2, 2,  2, 8],
    [4, 3, 3, 3, 3, 3, 3, 3, 3, 3, 3,  3,  3, 3, 3, 4, 3, 3, 3, 3, 3, 3, 3, 3,  3, 3, 3, 3,  3, 3,  3, 4],
    [4, 1, 1,  1,  1,  1,  1,  1,  1,  1,  1,  1,  1, 1, 1,  4,  1, 1, 1, 1,  1,  1,  1,  1,  1, 1,  1, 1,  1, 1,  1, 4],
    [4, 1, 1,  1,  1,  1,  1,  1,  1,  1,  1,  1,  1, 1, 1,  4,  1, 1, 1, 1,  1,  1,  1,  1,  1, 1,  1, 1,  1, 1,  1, 4],
    [4, 1, 1,  1,  1,  1,  1,  1,  1,  1,  1,  1,  1, 1, 1,  4,  1, 1, 1, 1,  1,  1,  1,  1,  1, 1,  1, 1,  1, 1,  1, 4],
    [4, 1, 1,  1,  1,  1,  1,  1,  1,  1,  1,  1,  1, 1, 1,  4,  1, 1, 1, 1,  1,  1,  1,  1,  1, 1,  1, 1,  1, 1,  1, 4],
    [4, 1, 1,  1,  1,  1,  1,  1,  1,  1,  1,  1,  1, 1, 1,  1,  1, 1, 1, 1,  1,  1,  1,  1,  1, 1,  1, 1,  1, 1,  1, 4],
    [4, 1, 1,  1,  1,  1,  1,  1,  1,  1,  1,  1,  1, 1, 1,  1,  1, 1, 1, 1,  1,  1,  1,  1,  1, 1,  1, 1,  1, 1,  1, 4],
    [4, 1, 1,  1,  1,  1,  1,  1,  1,  1,  1,  1,  1, 1, 1,  4,  1, 1, 1, 1,  1,  1,  1,  1,  1, 1,  1, 1,  1, 1,  1, 4],
    [4, 1, 1,  1,  1,  1,  1,  1,  1,  1,  1,  1,  1, 1, 1,  4,  1, 1, 1, 1,  1,  1,  1,  1,  1, 1,  1, 1,  1, 1,  1, 4],
    [4, 1, 1,  1,  1,  1,  1,  1,  1,  1,  1,  1,  1, 1, 1,  4,  1, 1, 1, 1,  1,  1,  1,  1,  1, 1,  1, 1,  1, 1,  1, 4],
    [4, 1, 1,  1,  1,  1,  1,  1,  1,  1,  1,  1,  1, 1, 1,  4,  1, 1, 1, 1,  1,  1,  1,  1,  1, 1,  1, 1,  1, 1,  1, 4],
    [4, 1, 1,  1,  1,  1,  1,  1,  1,  1,  1,  1,  1, 1, 1,  4,  1, 1, 1, 1,  1,  1,  1,  1,  1, 1,  1, 1,  1, 1,  1, 4],
    [4, 1, 1,  1,  1,  1,  1,  1,  1,  1,  1,  1,  1, 1, 1,  4,  1, 1, 1, 1,  1,  1,  1,  1,  1, 1,  1, 1,  1, 1,  1, 4],
    [7, 2, 2,  2,  2, 2, 2, 2, 2,  2, 2,  2,  2, 2, 2, 4, 2, 2, 2, 2, 2, 2, 2, 2,  2, 2, 1, 1,  2, 2,  2, 8],
    [4, 3, 3, 3, 3, 3, 3, 3, 3, 3, 3,  3,  3, 3, 3, 4, 3, 3, 3, 3, 3, 3, 3, 3,  3, 3, 1, 1,  3, 3,  3, 4],
    [4, 1, 1,  1,  1,  1,  1,  1,  1,  1,  1,  1,  1, 1, 1,  4,  1, 1, 1, 1,  1,  1,  1,  1,  1, 1,  1, 1,  1, 1,  1, 4],
    [4, 1, 1,  1,  1,  1,  1,  1,  1,  1,  1,  1,  1, 1, 1,  4,  1, 1, 1, 1,  1,  1,  1,  1,  1, 1,  1, 1,  1, 1,  1, 4],
    [4, 1, 1,  1,  1,  1,  1,  1,  1,  1,  1,  1,  1, 1, 1,  4,  1, 1, 1, 1,  1,  1,  1,  1,  1, 1,  1, 1,  1, 1,  1, 4],
    [4, 1, 1,  1,  1,  1,  1,  1,  1,  1,  1,  1,  1, 1, 1,  4,  1, 1, 1, 1,  1,  1,  1,  1,  1, 1,  1, 1,  1, 1,  1, 4],
    [4, 1, 1,  1,  1,  1,  1,  1,  1,  1,  1,  1,  1, 1, 1,  4,  1, 1, 1, 1,  1,  1,  1,  1,  1, 1,  1, 1,  1, 1,  1, 4],
    [4, 1, 1,  1,  1,  1,  1,  1,  1,  1,  1,  1,  1, 1, 1,  4,  1, 1, 1, 1,  1,  1,  1,  1,  1, 1,  1, 1,  1, 1,  1, 4],
    [4, 1, 1,  1,  1,  1,  1,  1,  1,  1,  1,  1,  1, 1, 1,  4,  1, 1, 1, 1,  1,  1,  1,  1,  1, 1,  1, 1,  1, 1,  1, 4],
    [4, 1, 1,  1,  1,  1,  1,  1,  1,  1,  1,  1,  1, 1, 1,  1,  1, 1, 1, 1,  1,  1,  1,  1,  1, 1,  1, 1,  1, 1,  1, 4],
    [4, 1, 1,  1,  1,  1,  1,  1,  1,  1,  1,  1,  1, 1, 1,  1,  1, 1, 1, 1,  1,  1,  1,  1,  1, 1,  1, 1,  1, 1,  1, 4],
    [4, 1, 1,  1,  1,  1,  1,  1,  1,  1,  1,  1,  1, 1, 1,  4,  1, 1, 1, 1,  1,  1,  1,  1,  1, 1,  1, 1,  1, 1,  1, 4],
    [4, 1, 1,  1,  1,  1,  1,  1,  1,  1,  1,  1,  1, 1, 1,  4,  1, 1, 1, 1,  1,  1,  1,  1,  1, 1,  1, 1,  1, 1,  1, 4],
    [4, 1, 1,  1,  1,  1,  1,  1,  1,  1,  1,  1,  1, 1, 1,  4,  1, 1, 1, 1,  1,  1,  1,  1,  1, 1,  1, 1,  1, 1,  1, 4],
    [4, 1, 1,  1,  1,  1,  1,  1,  1,  1,  1,  1,  1, 1, 1,  4,  1, 1, 1, 1,  1,  1,  1,  1,  1, 1,  1, 1,  1, 1,  1, 4],
    [4, 1, 1,  1,  1,  1,  1,  1,  1,  1,  1,  1,  1, 1, 1,  4,  1, 1, 1, 1,  1,  1,  1,  1,  1, 1,  1, 1,  1, 1,  1, 4],
    [4, 1, 1,  1,  1,  1,  1,  1,  1,  1,  1,  1,  1, 1, 1,  4,  1, 1, 1, 1,  1,  1,  1,  1,  1, 1,  1, 1,  1, 1,  1, 4],
    [5, 2, 2,  2,  2,  2,  2,  2,  2,  2,  2,  2, 25, 2, 2,  2,  2, 2, 2, 2,  2,  2,  2,  2,  2, 2,  2, 2,  2, 2,  2, 4]
  ],
  "foreground": [
    [0, 0, 0, 0, 0, 0, 0, 0, 0, 0, 0, 0, 0, 0, 0, 0, 0, 0, 0, 0, 0, 0, 0, 0, 0, 0, 0, 0, 0, 0, 0, 0],
    [0, 0, 0, 0, 0, 0, 0, 0, 0, 0, 0, 0, 0, 0, 0, 0, 0, 0, 0, 0, 0, 0, 0, 0, 0, 0, 0, 0, 0, 0, 0, 0],
    [0, 0, 0, 0, 0, 0, 0, 0, 0, 0, 0, 0, 0, 0, 0, 0, 0, 0, 0, 0, 0, 0, 0, 0, 0, 0, 0, 0, 0, 0, 0, 0],
    [0, 0, 0, 0, 0, 0, 0, 0, 0, 0, 0, 0, 0, 0, 0, 0, 0, 0, 0, 0, 0, 0, 0, 0, 0, 0, 0, 0, 0, 0, 0, 0],
    [0, 0, 0, 0, 0, 0, 0, 0, 0, 0, 0, 0, 0, 0, 0, 0, 0, 0, 0, 0, 0, 0, 0, 0, 0, 0, 0, 0, 0, 0, 0, 0],
    [0, 0, 0, 0, 0, 0, 0, 0, 0, 0, 0, 0, 0, 0, 0, 0, 0, 0, 0, 0, 0, 0, 0, 0, 0, 0, 0, 0, 0, 0, 0, 0],
    [0, 0, 0, 0, 0, 0, 0, 0, 0, 0, 0, 0, 0, 0, 0, 0, 0, 0, 0, 0, 0, 0, 0, 0, 0, 0, 0, 0, 0, 0, 0, 0],
    [0, 0, 0, 0, 0, 0, 0, 0, 0, 0, 0, 0, 0, 0, 0, 0, 0, 0, 0, 0, 0, 0, 0, 0, 0, 0, 0, 0, 0, 0, 0, 0],
    [0, 0, 0, 0, 0, 0, 0, 0, 0, 0, 0, 0, 0, 0, 0, 0, 0, 0, 0, 0, 0, 0, 0, 0, 0, 0, 0, 0, 0, 0, 0, 0],
    [0, 0, 0, 0, 0, 0, 0, 0, 0, 0, 0, 0, 0, 0, 0, 0, 0, 0, 0, 0, 0, 0, 0, 0, 0, 0, 0, 0, 0, 0, 0, 0],
    [0, 0, 0, 0, 0, 0, 0, 0, 0, 0, 0, 0, 0, 0, 0, 0, 0, 0, 0, 0, 0, 0, 0, 0, 0, 0, 0, 0, 0, 0, 0, 0],
    [0, 0, 0, 0, 0, 0, 0, 0, 0, 0, 0, 0, 0, 0, 0, 0, 0, 0, 0, 0, 0, 0, 0, 0, 0, 0, 0, 0, 0, 0, 0, 0],
    [0, 0, 0, 0, 0, 0, 0, 0, 0, 0, 0, 0, 0, 0, 0, 0, 0, 0, 0, 0, 0, 0, 0, 0, 0, 0, 0, 0, 0, 0, 0, 0],
    [0, 0, 0, 0, 0, 0, 0, 0, 0, 0, 0, 0, 0, 0, 0, 0, 0, 0, 0, 0, 0, 0, 0, 0, 0, 0, 0, 0, 0, 0, 0, 0],
    [0, 0, 0, 0, 0, 0, 0, 0, 0, 0, 0, 0, 0, 0, 0, 0, 0, 0, 0, 0, 0, 0, 0, 0, 0, 0, 0, 0, 0, 0, 0, 0],
    [0, 0, 0, 0, 0, 0, 0, 0, 0, 0, 0, 0, 0, 0, 0, 0, 0, 0, 0, 0, 0, 0, 0, 0, 0, 0, 0, 0, 0, 0, 0, 0],
    [0, 0, 0, 0, 0, 0, 0, 0, 0, 0, 0, 0, 0, 0, 0, 0, 0, 0, 0, 0, 0, 0, 0, 0, 0, 0, 0, 0, 0, 0, 0, 0],
    [0, 0, 0, 0, 0, 0, 0, 0, 0, 0, 0, 0, 0, 0, 0, 0, 0, 0, 0, 0, 0, 0, 0, 0, 0, 0, 0, 0, 0, 0, 0, 0],
    [0, 0, 0, 0, 0, 0, 0, 0, 0, 0, 0, 0, 0, 0, 0, 0, 0, 0, 0, 0, 0, 0, 0, 0, 0, 0, 0, 0, 0, 0, 0, 0],
    [0, 0, 0, 0, 0, 0, 0, 0, 0, 0, 0, 0, 0, 0, 0, 0, 0, 0, 0, 0, 0, 0, 0, 0, 0, 0, 0, 0, 0, 0, 0, 0],
    [0, 0, 0, 0, 0, 0, 0, 0, 0, 0, 0, 0, 0, 0, 0, 0, 0, 0, 0, 0, 0, 0, 0, 0, 0, 0, 0, 0, 0, 0, 0, 0],
    [0, 0, 0, 0, 0, 0, 0, 0, 0, 0, 0, 0, 0, 0, 0, 0, 0, 0, 0, 0, 0, 0, 0, 0, 0, 0, 0, 0, 0, 0, 0, 0],
    [0, 0, 0, 0, 0, 0, 0, 0, 0, 0, 0, 0, 0, 0, 0, 0, 0, 0, 0, 0, 0, 0, 0, 0, 0, 0, 0, 0, 0, 0, 0, 0],
    [0, 0, 0, 0, 0, 0, 0, 0, 0, 0, 0, 0, 0, 0, 0, 0, 0, 0, 0, 0, 0, 0, 0, 0, 0, 0, 0, 0, 0, 0, 0, 0],
    [0, 0, 0, 0, 0, 0, 0, 0, 0, 0, 0, 0, 0, 0, 0, 0, 0, 0, 0, 0, 0, 0, 0, 0, 0, 0, 0, 0, 0, 0, 0, 0],
    [0, 0, 0, 0, 0, 0, 0, 0, 0, 0, 0, 0, 0, 0, 0, 0, 0, 0, 0, 0, 0, 0, 0, 0, 0, 0, 0, 0, 0, 0, 0, 0],
    [0, 0, 0, 0, 0, 0, 0, 0, 0, 0, 0, 0, 0, 0, 0, 0, 0, 0, 0, 0, 0, 0, 0, 0, 0, 0, 0, 0, 0, 0, 0, 0],
    [0, 0, 0, 0, 0, 0, 0, 0, 0, 0, 0, 0, 0, 0, 0, 0, 0, 0, 0, 0, 0, 0, 0, 0, 0, 0, 0, 0, 0, 0, 0, 0],
    [0, 0, 0, 0, 0, 0, 0, 0, 0, 0, 0, 0, 0, 0, 0, 0, 0, 0, 0, 0, 0, 0, 0, 0, 0, 0, 0, 0, 0, 0, 0, 0],
    [0, 0, 0, 0, 0, 0, 0, 0, 0, 0, 0, 0, 0, 0, 0, 0, 0, 0, 0, 0, 0, 0, 0, 0, 0, 0, 0, 0, 0, 0, 0, 0],
    [0, 0, 0, 0, 0, 0, 0, 0, 0, 0, 0, 0, 0, 0, 0, 0, 0, 0, 0, 0, 0, 0, 0, 0, 0, 0, 0, 0, 0, 0, 0, 0],
    [0, 0, 0, 0, 0, 0, 0, 0, 0, 0, 0, 0, 0, 0, 0, 0, 0, 0, 0, 0, 0, 0, 0, 0, 0, 0, 0, 0, 0, 0, 0, 0]
  ],
  "enemies": [
    {
      "x": 100,
      "y": 300,
      "speed": 1.5,
      "minX": 50,
      "maxX": 200
    },
    {
      "x": 350,
      "y": 800,
      "speed": 1.5,
      "minX": 300,
      "maxX": 400
    },
    {
      "x": 450,
      "y": 100,
      "speed": 3.5,
      "minX": 400,
      "maxX": 650
    },
    {
      "x": 450,
      "y": 100,
      "speed": 3.5,
      "minX": 400,
      "maxX": 650
    },
    {
      "x": 250,
      "y": 700,
      "speed": 3.5,
      "minX": 200,
      "maxX": 650
    },
    {
      "x": 400,
      "y": 550,
      "speed": 10.5,
      "minX": 400,
      "maxX": 700
    },
    {
      "x": 50,
      "y": 650,
      "speed": 3.5,
      "minX": 40,
      "maxX": 100
    },
    {
      "x": 100,
      "y": 450,
      "speed": 10.5,
      "minX": 50,
      "maxX": 500
    },
    {
      "x": 600,
      "y": 200,
      "speed": 10.5,
      "minX": 500,
      "maxX": 700
    },


    {
      "x": 1300,
      "y": 300,
      "speed": 1.5,
      "minX": 1200,
      "maxX": 1400
    },
    {
      "x": 1650,
      "y": 800,
      "speed": 1.5,
      "minX": 1600,
      "maxX": 1900
    },
    {
      "x": 1750,
      "y": 100,
      "speed": 3.5,
      "minX": 1700,
      "maxX": 1850
    },
    {
      "x": 1350,
      "y": 100,
      "speed": 3.5,
      "minX": 1300,
      "maxX": 1450
    },
    {
      "x": 1450,
      "y": 700,
      "speed": 3.5,
      "minX": 1400,
      "maxX": 1650
    },
    {
      "x": 1600,
      "y": 550,
      "speed": 10.5,
      "minX": 1500,
      "maxX": 1650
    },
    {
      "x": 1250,
      "y": 650,
      "speed": 3.5,
      "minX": 1100,
      "maxX": 1300
    },
    {
      "x": 1300,
      "y": 450,
      "speed": 10.5,
      "minX": 1250,
      "maxX": 1800
    },
    {
      "x": 1500,
      "y": 200,
      "speed": 10.5,
      "minX": 1400,
      "maxX": 1700
    },



    {
      "x": 100,
      "y": 1300,
      "speed": 1.5,
      "minX": 50,
      "maxX": 200
    },
    {
      "x": 350,
      "y": 1800,
      "speed": 1.5,
      "minX": 300,
      "maxX": 400
    },
    {
      "x": 450,
      "y": 1100,
      "speed": 3.5,
      "minX": 400,
      "maxX": 650
    },
    {
      "x": 450,
      "y": 1100,
      "speed": 3.5,
      "minX": 400,
      "maxX": 650
    },
    {
      "x": 250,
      "y": 1700,
      "speed": 3.5,
      "minX": 200,
      "maxX": 650
    },
    {
      "x": 400,
      "y": 1650,
      "speed": 10.5,
      "minX": 400,
      "maxX": 700
    },
    {
      "x": 50,
      "y": 1650,
      "speed": 3.5,
      "minX": 40,
      "maxX": 100
    },
    {
      "x": 100,
      "y": 1450,
      "speed": 10.5,
      "minX": 50,
      "maxX": 500
    },
    {
      "x": 600,
      "y": 1200,
      "speed": 10.5,
      "minX": 500,
      "maxX": 700
    },



    {
      "x": 1300,
      "y": 1300,
      "speed": 1.5,
      "minX": 1200,
      "maxX": 1400
    },
    {
      "x": 1650,
      "y": 1800,
      "speed": 1.5,
      "minX": 1600,
      "maxX": 1900
    },
    {
      "x": 1750,
      "y": 1100,
      "speed": 3.5,
      "minX": 1700,
      "maxX": 1850
    },
    {
      "x": 1350,
      "y": 1100,
      "speed": 3.5,
      "minX": 1300,
      "maxX": 1450
    },
    {
      "x": 1450,
      "y": 1700,
      "speed": 3.5,
      "minX": 1400,
      "maxX": 1650
    },
    {
      "x": 1600,
      "y": 1550,
      "speed": 10.5,
      "minX": 1500,
      "maxX": 1650
    },
    {
      "x": 1250,
      "y": 1650,
      "speed": 3.5,
      "minX": 1100,
      "maxX": 1300
    },
    {
      "x": 1300,
      "y": 1450,
      "speed": 10.5,
      "minX": 1250,
      "maxX": 1800
    },
    {
      "x": 1500,
      "y": 1200,
      "speed": 10.5,
      "minX": 1400,
      "maxX": 1700
    }
  ]
}