{
  "width": 32,
  "height": 32,
  "tiles": [
    [7, 2, 2,  9,  2, 11, 12, 13,  2,  9, 33,  2,  2, 2, 2, 33,  2, 2, 2, 2, 11, 12, 13,  9,  2, 2, 37, 1,  1, 1,  1, 4],
    [4, 3, 3, 10,  3, 14, 15, 16,  3, 10, 34,  3,  3, 3, 3, 34,  3, 3, 3, 3, 14, 15, 16, 10,  3, 3, 38, 1,  1, 1,  1, 4],
    [4, 1, 1,  1,  1,  1,  1,  1,  1,  1,  1,  1,  1, 1, 1,  1,  1, 1, 1, 1,  1,  1,  1,  9,  1, 1,  1, 1,  1, 9,  1, 4],
    [4, 1, 1,  1,  1,  1,  1,  1,  1,  1,  1,  1,  1, 1, 1,  1,  1, 1, 1, 1,  1,  1,  1,  1,  1, 1,  1, 1,  1, 1,  1, 4],
    [4, 1, 1,  1,  1,  1,  1,  1,  1,  1,  1,  1,  1, 1, 1,  1,  1, 1, 1, 1,  1,  1,  1,  1,  1, 1,  1, 1,  1, 1,  1, 4],
    [4, 2, 2,  2, 37,  2,  2, 35,  2,  2,  2,  2, 32, 2, 2,  2, 35, 2, 2, 2, 28,  1,  1,  1, 28, 2, 37, 1,  1, 1,  1, 4],
    [4, 3, 3,  3, 38,  3,  3, 36,  3,  3,  3,  3,  4, 3, 3,  3, 36, 3, 3, 3, 27,  1,  1,  1, 27, 3, 38, 1,  1, 1,  1, 4],
    [4, 1, 1,  1,  1,  1,  1,  1,  1,  1,  1,  1,  4, 1, 1,  1,  1, 1, 1, 1,  1,  1,  1,  1,  1, 1,  1, 1,  1, 1,  1, 4],
    [4, 1, 1,  1,  1,  1,  1,  1,  1,  1,  1,  1,  1, 1, 1,  1,  1, 1, 1, 1,  1,  1,  1,  1,  1, 1,  1, 1,  1, 1,  1, 4],
    [4, 2, 2, 35,  2,  2,  2, 37,  2,  2, 33,  2, 32, 2, 2,  2,  2, 2, 1, 1,  1,  1,  1,  1,  1, 1,  1, 1,  1, 1,  1, 4],
    [4, 3, 3, 36,  3,  3,  3, 38,  3,  3, 34,  3,  4, 3, 3,  3,  3, 3, 1, 1,  1,  1,  1,  1,  1, 1,  1, 1,  1, 1,  1, 4],
    [4, 1, 1,  1,  1,  1,  1,  1,  1,  1,  1,  1,  4, 1, 1,  1,  1, 1, 1, 1,  1,  1,  1,  1,  1, 1,  1, 1,  1, 1,  1, 4],
    [4, 1, 1,  1,  1,  1,  1,  1,  1,  1,  1,  1,  4, 2, 2,  2,  2, 2, 2, 2,  2,  2,  1,  1,  1, 2,  2, 1,  1, 1,  1, 4],
    [4, 1, 1,  1,  1,  1,  1,  1,  1,  1,  1,  1,  4, 3, 3,  3,  3, 3, 3, 3,  3,  3,  1,  1,  1, 3,  3, 1,  1, 1,  1, 4],
    [4, 1, 1,  1,  1,  1,  1,  1,  1,  1,  1,  1,  4, 1, 1,  1,  1, 1, 1, 1,  1,  0,  1,  1,  1, 1,  1, 1,  1, 1,  1, 4],
    [4, 1, 1,  1,  1,  1,  1,  1,  1,  1,  1,  1,  4, 1, 1,  2,  2, 2, 2, 8,  1,  7,  2,  2,  2, 2,  2, 1,  1, 1,  1, 4],
    [4, 2, 2,  2, 21,  1,  1,  1, 21,  2, 32,  2,  2, 1, 1,  3,  3, 3, 3, 4,  1,  4,  3,  3,  3, 3,  3, 1,  1, 1,  1, 4],
    [4, 3, 3,  3, 22,  1,  1,  1, 22,  3,  4,  3,  3, 1, 1,  1,  1, 1, 1, 4,  1,  4,  1,  1,  1, 1,  1, 1,  1, 1,  1, 4],
    [4, 1, 1,  1, 23,  1,  1,  1, 23,  1,  4,  1,  1, 1, 1,  1,  1, 1, 1, 4,  1,  4,  1,  1,  1, 1,  1, 1,  1, 1,  1, 4],
    [4, 1, 1,  1,  1,  1,  1,  1,  1,  1,  4,  1,  1, 1, 1,  1,  1, 1, 1, 4,  1,  4,  1,  1,  1, 1,  1, 1,  1, 1,  1, 4],
    [4, 1, 1,  1,  1,  1,  1,  1,  1,  1,  4,  1,  4, 1, 1,  1,  1, 1, 1, 4,  1,  1,  1,  1,  1, 1,  1, 1,  1, 1,  1, 4],
    [4, 1, 1,  2,  2,  2,  2,  2,  2,  2,  2,  1,  4, 1, 1,  1,  1, 1, 1, 4,  1,  1,  1,  1,  1, 1,  1, 1,  1, 1,  1, 4],
    [4, 1, 1,  3,  3,  3,  3,  3,  3,  3,  3,  1,  4, 1, 1,  1,  1, 1, 1, 4,  1,  4,  1,  1,  1, 1,  1, 1,  1, 1,  1, 4],
    [4, 1, 1,  1,  1,  1,  1,  1,  1,  1,  1,  1,  4, 1, 1,  1,  1, 1, 1, 4,  1,  4,  1,  1,  1, 1,  1, 1,  1, 1,  1, 4],
    [4, 3, 3,  3, 22,  1,  1,  1, 22,  3,  4,  3,  3, 1, 1,  1,  1, 1, 1, 4,  1,  4,  1,  1,  1, 1,  1, 1,  1, 1,  1, 4],
    [4, 1, 1,  1, 23,  1,  1,  1, 23,  1,  4,  1,  1, 1, 1,  1,  1, 1, 1, 4,  1,  4,  1,  1,  1, 1,  1, 1,  1, 1,  1, 4],
    [4, 1, 1,  1,  1,  1,  1,  1,  1,  1,  4,  1,  1, 1, 1,  1,  1, 1, 1, 4,  1,  4,  1,  1,  1, 1,  1, 1,  1, 1,  1, 4],
    [4, 1, 1,  1,  1,  1,  1,  1,  1,  1,  4,  1,  4, 1, 1,  1,  1, 1, 1, 4,  1,  1,  1,  1,  1, 1,  1, 1,  1, 1,  1, 4],
    [4, 1, 1,  2,  2,  2,  2,  2,  2,  2,  2,  1,  4, 1, 1,  1,  1, 1, 1, 4,  1,  1,  1,  1,  1, 1,  1, 1,  1, 1,  1, 4],
    [4, 1, 1,  3,  3,  3,  3,  3,  3,  3,  3,  1,  4, 1, 1,  1,  1, 1, 1, 4,  1,  4,  1,  1,  1, 1,  1, 1,  1, 1,  1, 4],
    [4, 1, 1,  1,  1,  1,  1,  1,  1,  1,  1,  1,  4, 1, 1,  1,  1, 1, 1, 4,  1,  4,  1,  1,  1, 1,  1, 1,  1, 1,  1, 4],
    [5, 2, 2,  2,  2,  2,  2,  2,  2,  2,  2,  2, 25, 2, 2,  2,  2, 2, 2, 2,  2,  2,  2,  2,  2, 2,  2, 1,  1, 1,  1, 4]
  ],
  "foreground": [
    [0, 0, 0, 0, 0, 0, 0, 0, 0, 0, 0, 0, 0, 0, 0, 0, 0, 0, 0, 0, 0, 0, 0, 0, 0, 0, 0, 0, 0, 0, 0, 0],
    [0, 0, 0, 0, 0, 0, 0, 0, 0, 0, 0, 0, 0, 0, 0, 0, 0, 0, 0, 0, 0, 0, 0, 0, 0, 0, 0, 0, 0, 0, 0, 0],
    [0, 0, 0, 0, 0, 0, 0, 0, 0, 0, 0, 0, 0, 0, 0, 0, 0, 0, 0, 0, 0, 0, 0, 0, 0, 0, 0, 0, 0, 0, 0, 0],
    [0, 0, 0, 0, 0, 0, 0, 0, 0, 0, 0, 0, 0, 0, 0, 0, 0, 0, 0, 0, 0, 0, 0, 0, 0, 0, 0, 0, 0, 0, 0, 0],
    [0, 0, 0, 0, 0, 0, 0, 0, 0, 0, 0, 0, 0, 0, 0, 0, 0, 0, 0, 0, 0, 0, 0, 0, 0, 0, 0, 0, 0, 0, 0, 0],
    [0, 0, 0, 0, 0, 0, 0, 0, 0, 0, 0, 0, 0, 0, 0, 0, 0, 0, 0, 0, 0, 17, 0, 18, 0, 0, 0, 0, 0, 0, 0, 0],
    [0, 0, 0, 0, 0, 0, 0, 0, 0, 0, 0, 0, 2, 0, 0, 0, 0, 0, 0, 0, 0, 19, 0, 20, 0, 0, 0, 0, 0, 0, 0, 0],
    [0, 0, 0, 0, 0, 0, 0, 0, 0, 0, 0, 0, 3, 0, 0, 0, 0, 0, 0, 0, 0, 0, 0, 0, 0, 0, 0, 0, 0, 0, 0, 0],
    [0, 0, 0, 0, 0, 0, 0, 0, 0, 0, 0, 0, 0, 0, 0, 0, 0, 0, 0, 0, 0, 0, 0, 0, 0, 0, 0, 0, 0, 0, 0, 0],
    [0, 0, 0, 0, 0, 0, 0, 0, 0, 0, 0, 0, 0, 0, 0, 0, 0, 0, 17, 0, 0, 0, 0, 0, 0, 0, 0, 0, 0, 0, 0, 0],
    [0, 0, 0, 0, 0, 0, 0, 0, 0, 0, 0, 0, 0, 0, 0, 0, 0, 0, 19, 0, 0, 0, 0, 0, 0, 0, 0, 0, 0, 0, 0, 0],
    [0, 0, 0, 0, 0, 0, 0, 0, 0, 0, 0, 0, 0, 0, 0, 0, 0, 0, 0, 0, 0, 0, 0, 0, 0, 0, 0, 0, 0, 0, 0, 0],
    [0, 0, 0, 0, 0, 0, 0, 0, 0, 0, 0, 0, 0, 0, 0, 0, 0, 0, 0, 0, 0, 0, 17, 0, 18, 0, 0, 0, 0, 0, 0, 0],
    [0, 0, 0, 0, 0, 0, 0, 0, 0, 0, 0, 0, 0, 0, 0, 0, 0, 0, 0, 0, 0, 0, 19, 0, 20, 0, 0, 0, 0, 0, 0, 0],
    [0, 0, 0, 0, 0, 0, 0, 0, 0, 0, 0, 0, 0, 0, 0, 0, 0, 0, 0, 0, 0, 0, 0, 0, 0, 0, 0, 0, 0, 0, 0, 0],
    [0, 0, 0, 0, 0, 0, 0, 0, 0, 0, 0, 0, 0, 0, 18, 0, 0, 0, 0, 0, 0, 0, 0, 0, 0, 0, 0, 0, 0, 0, 0, 0],
    [0, 0, 0, 0, 0, 17, 0, 18, 0, 0, 0, 0, 0, 0, 20, 0, 0, 0, 0, 0, 0, 0, 0, 0, 0, 0, 0, 0, 0, 0, 0, 0],
    [0, 0, 0, 0, 0, 19, 0, 20, 0, 0, 0, 0, 0, 0, 0, 0, 0, 0, 0, 0, 0, 0, 0, 0, 0, 0, 0, 0, 0, 0, 0, 0],
    [0, 0, 0, 0, 0, 0, 0, 0, 0, 0, 0, 0, 0, 0, 0, 0, 0, 0, 0, 0, 0, 0, 0, 0, 0, 0, 0, 0, 0, 0, 0, 0],
    [0, 0, 0, 0, 0, 0, 0, 0, 0, 0, 0, 0, 0, 0, 0, 0, 0, 0, 0, 0, 0, 0, 0, 0, 0, 0, 0, 0, 0, 0, 0, 0],
    [0, 0, 0, 0, 0, 0, 0, 0, 0, 0, 0, 0, 0, 0, 0, 0, 0, 0, 0, 0, 0, 0, 0, 0, 0, 0, 0, 0, 0, 0, 0, 0],
    [0, 0, 18, 0, 0, 0, 0, 0, 0, 0, 0, 0, 0, 0, 0, 0, 0, 0, 0, 0, 0, 0, 0, 0, 0, 0, 0, 0, 0, 0, 0, 0],
    [0, 0, 20, 0, 0, 0, 0, 0, 0, 0, 0, 0, 0, 0, 0, 0, 0, 0, 0, 0, 0, 0, 0, 0, 0, 0, 0, 0, 0, 0, 0, 0],
    [0, 0, 0, 0, 0, 17, 0, 18, 0, 0, 0, 0, 0, 0, 20, 0, 0, 0, 0, 0, 0, 0, 0, 0, 0, 0, 0, 0, 0, 0, 0, 0],
    [0, 0, 0, 0, 0, 19, 0, 20, 0, 0, 0, 0, 0, 0, 0, 0, 0, 0, 0, 0, 0, 0, 0, 0, 0, 0, 0, 0, 0, 0, 0, 0],
    [0, 0, 0, 0, 0, 0, 0, 0, 0, 0, 0, 0, 0, 0, 0, 0, 0, 0, 0, 0, 0, 0, 0, 0, 0, 0, 0, 0, 0, 0, 0, 0],
    [0, 0, 0, 0, 0, 0, 0, 0, 0, 0, 0, 0, 0, 0, 0, 0, 0, 0, 0, 0, 0, 0, 0, 0, 0, 0, 0, 0, 0, 0, 0, 0],
    [0, 0, 0, 0, 0, 0, 0, 0, 0, 0, 0, 0, 0, 0, 0, 0, 0, 0, 0, 0, 0, 0, 0, 0, 0, 0, 0, 0, 0, 0, 0, 0],
    [0, 0, 18, 0, 0, 0, 0, 0, 0, 0, 0, 0, 0, 0, 0, 0, 0, 0, 0, 0, 0, 0, 0, 0, 0, 0, 0, 0, 0, 0, 0, 0],
    [0, 0, 20, 0, 0, 0, 0, 0, 0, 0, 0, 0, 0, 0, 0, 0, 0, 0, 0, 0, 0, 0, 0, 0, 0, 0, 0, 0, 0, 0, 0, 0],
    [0, 0, 0, 0, 0, 0, 0, 0, 0, 0, 0, 0, 0, 0, 0, 0, 0, 0, 0, 0, 0, 0, 0, 0, 0, 0, 0, 0, 0, 0, 0, 0],
    [0, 0, 0, 0, 0, 0, 0, 0, 0, 0, 0, 0, 0, 0, 0, 0, 0, 0, 0, 0, 0, 0, 0, 0, 0, 0, 0, 0, 0, 0, 0, 0],
    [0, 0, 0, 0, 0, 0, 0, 0, 0, 0, 0, 0, 0, 0, 0, 0, 0, 0, 0, 0, 0, 0, 0, 0, 0, 0, 0, 0, 0, 0, 0, 0]
  ]
}