{
  "width": 16,
  "height": 16,
  "tiles": [
    [7, 2, 2,  2,  2,  2,  2, 11, 12, 13,  2,  2,  2, 2, 2, 8],
    [4, 3, 3,  3,  3,  3,  3, 14, 15, 16,  3,  3,  3, 3, 3, 4],
    [4, 1, 1,  1,  1,  1,  1,  1,  1,  1,  1,  1,  1, 1, 1, 4],
    [4, 1, 1,  1,  1,  1,  1,  1,  1,  1,  1,  1,  1, 1, 1, 4],
    [4, 1, 1,  1,  1,  1,  1,  1,  1,  1,  1,  1,  1, 1, 1, 4],
    [4, 1, 1,  1,  1,  1,  1,  1,  1,  1,  1,  1,  1, 1, 1, 4],
    [4, 1, 1,  1,  1,  1,  1,  1,  1,  1,  1,  1,  1, 1, 1, 4],
    [4, 1, 1,  1,  1,  1,  1,  1,  1,  1,  1,  1,  1, 1, 1, 4],
    [4, 1, 1,  1,  1,  1,  1,  1,  1,  1,  1,  1,  1, 1, 1, 4],
    [4, 1, 1,  1,  1,  1,  1,  1,  1,  1,  1,  1,  1, 1, 1, 4],
    [4, 1, 1,  1,  1,  1,  1,  1,  1,  1,  1,  1,  1, 1, 1, 4],
    [4, 1, 1,  1,  1,  1,  1,  1,  1,  1,  1,  1,  1, 1, 1, 4],
    [4, 1, 1,  1,  1,  1,  1,  1,  1,  1,  1,  1,  1, 1, 1, 4],
    [4, 1, 1,  1,  1,  1,  1,  1,  1,  1,  1,  1,  1, 1, 1, 4],
    [4, 1, 1,  1,  1,  1,  1,  1,  1,  1,  1,  1,  1, 1, 1, 4],
    [2, 2, 2,  2,  2,  2,  2,  2,  2,  2,  2,  2,  2, 2, 2, 2]
  ],
  "foreground": [
    [0, 0, 0, 0, 0, 0, 0, 0, 0, 0, 0, 0, 0, 0, 0, 0],
    [0, 0, 0, 0, 0, 0, 0, 0, 0, 0, 0, 0, 0, 0, 0, 0],
    [0, 0, 0, 0, 0, 0, 0, 0, 0, 0, 0, 0, 0, 0, 0, 0],
    [0, 0, 0, 0, 0, 0, 0, 0, 0, 0, 0, 0, 0, 0, 0, 0],
    [0, 0, 0, 0, 0, 0, 0, 0, 0, 0, 0, 0, 0, 0, 0, 0],
    [0, 0, 0, 0, 0, 0, 0, 0, 0, 0, 0, 0, 0, 0, 0, 0],
    [0, 0, 0, 0, 0, 0, 0, 0, 0, 0, 0, 0, 0, 0, 0, 0],
    [0, 0, 0, 0, 0, 0, 0, 0, 0, 0, 0, 0, 0, 0, 0, 0],
    [0, 0, 0, 0, 0, 0, 0, 0, 0, 0, 0, 0, 0, 0, 0, 0],
    [0, 0, 0, 0, 0, 0, 0, 0, 0, 0, 0, 0, 0, 0, 0, 0],
    [0, 0, 0, 0, 0, 0, 0, 0, 0, 0, 0, 0, 0, 0, 0, 0],
    [0, 0, 0, 0, 0, 0, 0, 0, 0, 0, 0, 0, 0, 0, 0, 0],
    [0, 0, 0, 0, 0, 0, 0, 0, 0, 0, 0, 0, 0, 0, 0, 0],
    [0, 0, 0, 0, 0, 0, 0, 0, 0, 0, 0, 0, 0, 0, 0, 0],
    [0, 0, 0, 0, 0, 0, 0, 0, 0, 0, 0, 0, 0, 0, 0, 0],
    [0, 0, 0, 0, 0, 0, 0, 0, 0, 0, 0, 0, 0, 0, 0, 0]
  ],
  "enemies": [
    {
      "x": 100,
      "y": 300,
      "speed": 1.5,
      "minX": 50,
      "maxX": 200
    },
    {
      "x": 350,
      "y": 800,
      "speed": 1.5,
      "minX": 300,
      "maxX": 400
    },
    {
      "x": 450,
      "y": 100,
      "speed": 3.5,
      "minX": 400,
      "maxX": 650
    },
    {
      "x": 600,
      "y": 850,
      "speed": 6.5,
      "minX": 500,
      "maxX": 700
    },
    {
      "x": 450,
      "y": 100,
      "speed": 3.5,
      "minX": 400,
      "maxX": 650
    },
    {
      "x": 600,
      "y": 850,
      "speed": 6.5,
      "minX": 500,
      "maxX": 700
    },
    {
      "x": 250,
      "y": 700,
      "speed": 3.5,
      "minX": 200,
      "maxX": 650
    },
    {
      "x": 400,
      "y": 550,
      "speed": 10.5,
      "minX": 400,
      "maxX": 700
    },
    {
      "x": 50,
      "y": 500,
      "speed": 3.5,
      "minX": 40,
      "maxX": 100
    },
    {
      "x": 100,
      "y": 450,
      "speed": 10.5,
      "minX": 50,
      "maxX": 500
    },
    {
      "x": 600,
      "y": 200,
      "speed": 10.5,
      "minX": 500,
      "maxX": 700
    }

  ]
}