{
  "width": 28,
  "height": 25,
  "tiles": [
    [7, 2, 2,  9,  2, 11, 12, 13,  2,  9, 33,  2,  2, 2, 2, 33,  2, 2, 2, 2, 11, 12, 13,  9,  2, 2, 37, 8],
    [4, 3, 3, 10,  3, 14, 15, 16,  3, 10, 34,  3,  3, 3, 3, 34,  3, 3, 3, 3, 14, 15, 16, 10,  3, 3, 38, 4],
    [4, 1, 1,  1,  1,  1,  1,  1,  1,  1,  1,  1,  1, 1, 1,  1,  1, 1, 1, 1,  1,  1,  1,  1,  1, 1,  1, 4],
    [4, 1, 1,  1,  1,  1,  1,  1,  1,  1,  1,  1,  1, 1, 1,  1,  1, 1, 1, 1,  1,  1,  1,  1,  1, 1,  1, 4],
    [4, 1, 1,  1,  1,  1,  1,  1,  1,  1,  1,  1,  1, 1, 1,  1,  1, 1, 1, 1,  1,  1,  1,  1,  1, 1,  1, 4],
    [4, 2, 2,  2, 37,  2,  2, 35,  2,  2,  2,  2, 32, 2, 2,  2, 35, 2, 2, 2, 28,  1,  1,  1, 28, 2, 37, 4],
    [4, 3, 3,  3, 38,  3,  3, 36,  3,  3,  3,  3,  4, 3, 3,  3, 36, 3, 3, 3, 27,  1,  1,  1, 27, 3, 38, 4],
    [4, 1, 1,  1,  1,  1,  1,  1,  1,  1,  1,  1,  4, 1, 1,  1,  1, 1, 1, 1,  1,  1,  1,  1,  1, 1,  1, 4],
    [4, 1, 1,  1,  1,  1,  1,  1,  1,  1,  1,  1,  1, 1, 1,  1,  1, 1, 1, 1,  1,  1,  1,  1,  1, 1,  1, 4],
    [4, 2, 2, 35,  2,  2,  2, 37,  2,  2, 33,  2, 32, 2, 2,  2,  2, 2, 1, 1,  1,  1,  1,  1,  1, 1,  1, 4],
    [4, 3, 3, 36,  3,  3,  3, 38,  3,  3, 34,  3,  4, 3, 3,  3,  3, 3, 1, 1,  1,  1,  1,  1,  1, 1,  1, 4],
    [4, 1, 1,  1,  1,  1,  1,  1,  1,  1,  1,  1,  4, 1, 1,  1,  1, 1, 1, 1,  1,  1,  1,  1,  1, 1,  1, 4],
    [4, 1, 1,  1,  1,  1,  1,  1,  1,  1,  1,  1,  4, 2, 2,  2,  2, 2, 2, 2,  2,  2,  1,  1,  1, 2,  2, 4],
    [4, 1, 1,  1,  1,  1,  1,  1,  1,  1,  1,  1,  4, 3, 3,  3,  3, 3, 3, 3,  3,  3,  1,  1,  1, 3,  3, 4],
    [4, 1, 1,  1,  1,  1,  1,  1,  1,  1,  1,  1,  4, 1, 1,  1,  1, 1, 1, 1,  1,  0,  1,  1,  1, 1,  1, 4],
    [4, 1, 1,  1,  1,  1,  1,  1,  1,  1,  1,  1,  4, 1, 1,  2,  2, 2, 2, 8,  1,  7,  2,  2,  2, 2,  2, 4],
    [4, 2, 2,  2, 21,  1,  1,  1, 21,  2, 32,  2,  2, 1, 1,  3,  3, 3, 3, 4,  1,  4,  3,  3,  3, 3,  3, 4],
    [4, 3, 3,  3, 22,  1,  1,  1, 22,  3,  4,  3,  3, 1, 1,  1,  1, 1, 1, 4,  1,  4,  1,  1,  1, 1,  1, 4],
    [4, 1, 1,  1, 23,  1,  1,  1, 23,  1,  4,  1,  1, 1, 1,  1,  1, 1, 1, 4,  1,  4,  1,  1,  1, 1,  1, 4],
    [4, 1, 1,  1,  1,  1,  1,  1,  1,  1,  4,  1,  1, 1, 1,  1,  1, 1, 1, 4,  1,  4,  1,  1,  1, 1,  1, 4],
    [4, 1, 1,  1,  1,  1,  1,  1,  1,  1,  4,  1,  4, 1, 1,  1,  1, 1, 1, 4,  1,  1,  1,  1,  1, 1,  1, 4],
    [4, 1, 1,  2,  2,  2,  2,  2,  2,  2,  2,  1,  4, 1, 1,  1,  1, 1, 1, 4,  1,  1,  1,  1,  1, 1,  1, 4],
    [4, 1, 1,  3,  3,  3,  3,  3,  3,  3,  3,  1,  4, 1, 1,  1,  1, 1, 1, 4,  1,  4,  1,  1,  1, 1,  1, 4],
    [4, 1, 1,  1,  1,  1,  1,  1,  1,  1,  1,  1,  4, 1, 1,  1,  1, 1, 1, 4,  1,  4,  1,  1,  1, 1,  1, 4],
    [5, 2, 2,  2,  2,  2,  2,  2,  2,  2,  2,  2, 25, 2, 2,  2,  2, 2, 2, 2,  2,  2,  2,  2,  2, 2,  2, 6]
  ],
  "foreground": [
    [0, 0, 0, 0, 0, 0, 0, 0, 0, 0, 0, 0, 0, 0, 0, 0, 0, 0, 0, 0, 0, 0, 0, 0, 0, 0, 0, 0],
    [0, 0, 0, 0, 0, 0, 0, 0, 0, 0, 0, 0, 0, 0, 0, 0, 0, 0, 0, 0, 0, 0, 0, 0, 0, 0, 0, 0],
    [0, 0, 0, 0, 0, 0, 0, 0, 0, 0, 0, 0, 0, 0, 0, 0, 0, 0, 0, 0, 0, 0, 0, 0, 0, 0, 0, 0],
    [0, 0, 0, 0, 0, 0, 0, 0, 0, 0, 0, 0, 0, 0, 0, 0, 0, 0, 0, 0, 0, 0, 0, 0, 0, 0, 0, 0],
    [0, 0, 0, 0, 0, 0, 0, 0, 0, 0, 0, 0, 0, 0, 0, 0, 0, 0, 0, 0, 0, 0, 0, 0, 0, 0, 0, 0],
    [0, 0, 0, 0, 0, 0, 0, 0, 0, 0, 0, 0, 0, 0, 0, 0, 0, 0, 0, 0, 0, 17, 0, 18, 0, 0, 0, 0],
    [0, 0, 0, 0, 0, 0, 0, 0, 0, 0, 0, 0, 2, 0, 0, 0, 0, 0, 0, 0, 0, 19, 0, 20, 0, 0, 0, 0],
    [0, 0, 0, 0, 0, 0, 0, 0, 0, 0, 0, 0, 3, 0, 0, 0, 0, 0, 0, 0, 0, 0, 0, 0, 0, 0, 0, 0],
    [0, 0, 0, 0, 0, 0, 0, 0, 0, 0, 0, 0, 0, 0, 0, 0, 0, 0, 0, 0, 0, 0, 0, 0, 0, 0, 0, 0],
    [0, 0, 0, 0, 0, 0, 0, 0, 0, 0, 0, 0, 0, 0, 0, 0, 0, 0, 17, 0, 0, 0, 0, 0, 0, 0, 0, 0],
    [0, 0, 0, 0, 0, 0, 0, 0, 0, 0, 0, 0, 0, 0, 0, 0, 0, 0, 19, 0, 0, 0, 0, 0, 0, 0, 0, 0],
    [0, 0, 0, 0, 0, 0, 0, 0, 0, 0, 0, 0, 0, 0, 0, 0, 0, 0, 0, 0, 0, 0, 0, 0, 0, 0, 0, 0],
    [0, 0, 0, 0, 0, 0, 0, 0, 0, 0, 0, 0, 0, 0, 0, 0, 0, 0, 0, 0, 0, 0, 17, 0, 18, 0, 0, 0],
    [0, 0, 0, 0, 0, 0, 0, 0, 0, 0, 0, 0, 0, 0, 0, 0, 0, 0, 0, 0, 0, 0, 19, 0, 20, 0, 0, 0],
    [0, 0, 0, 0, 0, 0, 0, 0, 0, 0, 0, 0, 0, 0, 0, 0, 0, 0, 0, 0, 0, 0, 0, 0, 0, 0, 0, 0],
    [0, 0, 0, 0, 0, 0, 0, 0, 0, 0, 0, 0, 0, 0, 18, 0, 0, 0, 0, 0, 0, 0, 0, 0, 0, 0, 0, 0],
    [0, 0, 0, 0, 0, 17, 0, 18, 0, 0, 0, 0, 0, 0, 20, 0, 0, 0, 0, 0, 0, 0, 0, 0, 0, 0, 0, 0],
    [0, 0, 0, 0, 0, 19, 0, 20, 0, 0, 0, 0, 0, 0, 0, 0, 0, 0, 0, 0, 0, 0, 0, 0, 0, 0, 0, 0],
    [0, 0, 0, 0, 0, 0, 0, 0, 0, 0, 0, 0, 0, 0, 0, 0, 0, 0, 0, 0, 0, 0, 0, 0, 0, 0, 0, 0],
    [0, 0, 0, 0, 0, 0, 0, 0, 0, 0, 0, 0, 0, 0, 0, 0, 0, 0, 0, 0, 0, 0, 0, 0, 0, 0, 0, 0],
    [0, 0, 0, 0, 0, 0, 0, 0, 0, 0, 0, 0, 0, 0, 0, 0, 0, 0, 0, 0, 0, 0, 0, 0, 0, 0, 0, 0],
    [0, 0, 18, 0, 0, 0, 0, 0, 0, 0, 0, 0, 0, 0, 0, 0, 0, 0, 0, 0, 0, 0, 0, 0, 0, 0, 0, 0],
    [0, 0, 20, 0, 0, 0, 0, 0, 0, 0, 0, 0, 0, 0, 0, 0, 0, 0, 0, 0, 0, 0, 0, 0, 0, 0, 0, 0],
    [0, 0, 0, 0, 0, 0, 0, 0, 0, 0, 0, 0, 0, 0, 0, 0, 0, 0, 0, 0, 0, 0, 0, 0, 0, 0, 0, 0],
    [0, 0, 0, 0, 0, 0, 0, 0, 0, 0, 0, 0, 0, 0, 0, 0, 0, 0, 0, 0, 0, 0, 0, 0, 0, 0, 0, 0]
  ],
  "enemies": [
    {
      "x": 350,
      "y": 800,
      "speed": 1.5,
      "minX": 300,
      "maxX": 400
    },
    {
      "x": 150,
      "y": 900,
      "speed": 5.5,
      "minX": 100,
      "maxX": 300
    },
    {
      "x": 550,
      "y": 700,
      "speed": 2.5,
      "minX": 500,
      "maxX": 650
    },
    {
      "x": 150,
      "y": 750,
      "speed": 10.5,
      "minX": 100,
      "maxX": 160
    },
    {
      "x": 550,
      "y": 850,
      "speed": 2.5,
      "minX": 400,
      "maxX": 551
    },


    {
      "x": 550,
      "y": 100,
      "speed": 2.5,
      "minX": 500,
      "maxX": 600
    },
    {
      "x": 750,
      "y": 200,
      "speed": 3.5,
      "minX": 700,
      "maxX": 800
    },
    {
      "x": 250,
      "y": 120,
      "speed": 4.5,
      "minX": 200,
      "maxX": 400
    },
    {
      "x": 1150,
      "y": 100,
      "speed": 7.5,
      "minX": 1100,
      "maxX": 1300
    },
    {
      "x": 1450,
      "y": 220,
      "speed": 1.5,
      "minX": 1400,
      "maxX": 1600
    },
    {
      "x": 950,
      "y": 150,
      "speed": 4.5,
      "minX": 900,
      "maxX": 1100
    },



    {
      "x": 550,
      "y": 400,
      "speed": 2.5,
      "minX": 500,
      "maxX": 600
    },
    {
      "x": 750,
      "y": 470,
      "speed": 3.5,
      "minX": 700,
      "maxX": 800
    },
    {
      "x": 250,
      "y": 450,
      "speed": 4.5,
      "minX": 100,
      "maxX": 300
    },

    {
      "x": 1150,
      "y": 450,
      "speed": 7.5,
      "minX": 1100,
      "maxX": 1300
    },
    {
      "x": 1450,
      "y": 600,
      "speed": 1.5,
      "minX": 1400,
      "maxX": 1600
    },
    {
      "x": 950,
      "y": 660,
      "speed": 4.5,
      "minX": 900,
      "maxX": 1100
    },
    {
      "x": 1050,
      "y": 860,
      "speed": 6.5,
      "minX": 1000,
      "maxX": 1100
    },



    {
      "x": 1050,
      "y": 1060,
      "speed": 6.5,
      "minX": 1000,
      "maxX": 1100
    },
    {
      "x": 950,
      "y": 1260,
      "speed": 6.5,
      "minX": 900,
      "maxX": 1000
    },
    {
      "x": 1050,
      "y": 1360,
      "speed": 7.5,
      "minX": 900,
      "maxX": 1100
    },
    {
      "x": 850,
      "y": 1450,
      "speed": 6.5,
      "minX": 800,
      "maxX": 900
    },

    {
      "x": 450,
      "y": 1450,
      "speed": 6.5,
      "minX": 200,
      "maxX": 600
    },



    {
      "x": 170,
      "y": 1200,
      "speed": 6.5,
      "minX": 150,
      "maxX": 200
    },    {
      "x": 250,
      "y": 1150,
      "speed": 8.5,
      "minX": 200,
      "maxX": 400
    },    {
      "x": 300,
      "y": 1250,
      "speed": 2.5,
      "minX": 250,
      "maxX": 500
    },





    {
      "x": 1500,
      "y": 1060,
      "speed": 6.5,
      "minX": 1450,
      "maxX": 1550
    },
    {
      "x": 1450,
      "y": 1260,
      "speed": 6.5,
      "minX": 1400,
      "maxX": 1500
    },
    {
      "x": 1550,
      "y": 1450,
      "speed": 6.5,
      "minX": 1400,
      "maxX": 1600
    }
  ]
}
