{
  "width": 32,
  "height": 32,
  "tiles": [
    [7, 2, 2,  2,  2, 2, 2, 2, 2,  2, 2,  2,  2, 2, 2, 2, 2, 2, 2, 2, 2, 2, 2, 2,  2, 2, 2, 2,  2, 2,  2, 8],
    [4, 3, 3, 3, 3, 3, 3, 3, 3, 3, 3,  3,  3, 3, 3, 3, 3, 3, 3, 3, 3, 3, 3, 3,  3, 3, 3, 3,  3, 3,  3, 4],
    [4, 1, 1,  1,  1,  1,  1,  1,  1,  1,  1,  1,  1, 1, 1,  1,  1, 1, 1, 1,  1,  1,  1,  1,  1, 1,  1, 1,  1, 1,  1, 4],
    [4, 1, 1,  1,  1,  1,  1,  1,  1,  1,  1,  1,  1, 1, 1,  1,  1, 1, 1, 1,  1,  1,  1,  1,  1, 1,  1, 1,  1, 1,  1, 4],
    [4, 1, 1,  1,  1,  1,  1,  1,  1,  1,  1,  1,  1, 1, 1,  1,  1, 1, 1, 1,  1,  1,  1,  1,  1, 1,  1, 1,  1, 1,  1, 4],
    [4, 1, 1,  1,  1,  1,  1,  1,  1,  1,  1,  1,  1, 1, 1,  1,  1, 1, 1, 1,  1,  1,  1,  1,  1, 1,  1, 1,  1, 1,  1, 4],
    [4, 1, 1,  1,  1,  1,  1,  1,  1,  1,  1,  1,  1, 1, 1,  1,  1, 1, 1, 1,  1,  1,  1,  1,  1, 1,  1, 1,  1, 1,  1, 4],
    [4, 1, 1,  1,  1,  1,  1,  1,  1,  1,  1,  1,  1, 1, 1,  1,  1, 1, 1, 1,  1,  1,  1,  1,  1, 1,  1, 1,  1, 1,  1, 4],
    [4, 1, 1,  1,  1,  1,  1,  1,  1,  1,  1,  1,  1, 1, 1,  1,  1, 1, 1, 1,  1,  1,  1,  1,  1, 1,  1, 1,  1, 1,  1, 4],
    [4, 1, 1,  1,  1,  1,  1,  1,  1,  1,  1,  1,  1, 1, 1,  1,  1, 1, 1, 1,  1,  1,  1,  1,  1, 1,  1, 1,  1, 1,  1, 4],
    [4, 1, 1,  1,  1,  1,  1,  1,  1,  1,  1,  1,  1, 1, 1,  1,  1, 1, 1, 1,  1,  1,  1,  1,  1, 1,  1, 1,  1, 1,  1, 4],
    [4, 1, 1,  1,  1,  1,  1,  1,  1,  1,  1,  1,  1, 1, 1,  1,  1, 1, 1, 1,  1,  1,  1,  1,  1, 1,  1, 1,  1, 1,  1, 4],
    [4, 1, 1,  1,  1,  1,  1,  1,  1,  1,  1,  1,  1, 1, 1,  1,  1, 1, 1, 1,  1,  1,  1,  1,  1, 1,  1, 1,  1, 1,  1, 4],
    [4, 1, 1,  1,  1,  1,  1,  1,  1,  1,  1,  1,  1, 1, 1,  1,  1, 1, 1, 1,  1,  1,  1,  1,  1, 1,  1, 1,  1, 1,  1, 4],
    [4, 1, 1,  1,  1,  1,  1,  1,  1,  1,  1,  1,  1, 1, 1,  1,  1, 1, 1, 1,  1,  1,  1,  1,  1, 1,  1, 1,  1, 1,  1, 4],
    [4, 1, 1,  1,  1,  1,  1,  1,  1,  1,  1,  1,  1, 1, 1,  1,  1, 1, 1, 1,  1,  1,  1,  1,  1, 1,  1, 1,  1, 1,  1, 4],
    [4, 1, 1,  1,  1,  1,  1,  1,  1,  1,  1,  1,  1, 1, 1,  1,  1, 1, 1, 1,  1,  1,  1,  1,  1, 1,  1, 1,  1, 1,  1, 4],
    [4, 1, 1,  1,  1,  1,  1,  1,  1,  1,  1,  1,  1, 1, 1,  1,  1, 1, 1, 1,  1,  1,  1,  1,  1, 1,  1, 1,  1, 1,  1, 4],
    [4, 1, 1,  1,  1,  1,  1,  1,  1,  1,  1,  1,  1, 1, 1,  1,  1, 1, 1, 1,  1,  1,  1,  1,  1, 1,  1, 1,  1, 1,  1, 4],
    [4, 1, 1,  1,  1,  1,  1,  1,  1,  1,  1,  1,  1, 1, 1,  1,  1, 1, 1, 1,  1,  1,  1,  1,  1, 1,  1, 1,  1, 1,  1, 4],
    [4, 1, 1,  1,  1,  1,  1,  1,  1,  1,  1,  1,  1, 1, 1,  1,  1, 1, 1, 1,  1,  1,  1,  1,  1, 1,  1, 1,  1, 1,  1, 4],
    [4, 1, 1,  1,  1,  1,  1,  1,  1,  1,  1,  1,  1, 1, 1,  1,  1, 1, 1, 1,  1,  1,  1,  1,  1, 1,  1, 1,  1, 1,  1, 4],
    [4, 1, 1,  1,  1,  1,  1,  1,  1,  1,  1,  1,  1, 1, 1,  1,  1, 1, 1, 1,  1,  1,  1,  1,  1, 1,  1, 1,  1, 1,  1, 4],
    [4, 1, 1,  1,  1,  1,  1,  1,  1,  1,  1,  1,  1, 1, 1,  1,  1, 1, 1, 1,  1,  1,  1,  1,  1, 1,  1, 1,  1, 1,  1, 4],
    [4, 1, 1,  1,  1,  1,  1,  1,  1,  1,  1,  1,  1, 1, 1,  1,  1, 1, 1, 1,  1,  1,  1,  1,  1, 1,  1, 1,  1, 1,  1, 4],
    [4, 1, 1,  1,  1,  1,  1,  1,  1,  1,  1,  1,  1, 1, 1,  1,  1, 1, 1, 1,  1,  1,  1,  1,  1, 1,  1, 1,  1, 1,  1, 4],
    [4, 1, 1,  1,  1,  1,  1,  1,  1,  1,  1,  1,  1, 1, 1,  1,  1, 1, 1, 1,  1,  1,  1,  1,  1, 1,  1, 1,  1, 1,  1, 4],
    [4, 1, 1,  1,  1,  1,  1,  1,  1,  1,  1,  1,  1, 1, 1,  1,  1, 1, 1, 1,  1,  1,  1,  1,  1, 1,  1, 1,  1, 1,  1, 4],
    [4, 1, 1,  1,  1,  1,  1,  1,  1,  1,  1,  1,  1, 1, 1,  1,  1, 1, 1, 1,  1,  1,  1,  1,  1, 1,  1, 1,  1, 1,  1, 4],
    [4, 1, 1,  1,  1,  1,  1,  1,  1,  1,  1,  1,  1, 1, 1,  1,  1, 1, 1, 1,  1,  1,  1,  1,  1, 1,  1, 1,  1, 1,  1, 4],
    [4, 1, 1,  1,  1,  1,  1,  1,  1,  1,  1,  1,  1, 1, 1,  1,  1, 1, 1, 1,  1,  1,  1,  1,  1, 1,  1, 1,  1, 1,  1, 4],
    [5, 2, 2,  2,  2,  2,  2,  2,  2,  2,  2,  2, 25, 2, 2,  2,  2, 2, 2, 2,  2,  2,  2,  2,  2, 2,  2, 2,  2, 2,  2, 4]
  ],
  "foreground": [
    [0, 0, 0, 0, 0, 0, 0, 0, 0, 0, 0, 0, 0, 0, 0, 0, 0, 0, 0, 0, 0, 0, 0, 0, 0, 0, 0, 0, 0, 0, 0, 0],
    [0, 0, 0, 0, 0, 0, 0, 0, 0, 0, 0, 0, 0, 0, 0, 0, 0, 0, 0, 0, 0, 0, 0, 0, 0, 0, 0, 0, 0, 0, 0, 0],
    [0, 0, 0, 0, 0, 0, 0, 0, 0, 0, 0, 0, 0, 0, 0, 0, 0, 0, 0, 0, 0, 0, 0, 0, 0, 0, 0, 0, 0, 0, 0, 0],
    [0, 0, 0, 0, 0, 0, 0, 0, 0, 0, 0, 0, 0, 0, 0, 0, 0, 0, 0, 0, 0, 0, 0, 0, 0, 0, 0, 0, 0, 0, 0, 0],
    [0, 0, 0, 0, 0, 0, 0, 0, 0, 0, 0, 0, 0, 0, 0, 0, 0, 0, 0, 0, 0, 0, 0, 0, 0, 0, 0, 0, 0, 0, 0, 0],
    [0, 0, 0, 0, 0, 0, 0, 0, 0, 0, 0, 0, 0, 0, 0, 0, 0, 0, 0, 0, 0, 0, 0, 0, 0, 0, 0, 0, 0, 0, 0, 0],
    [0, 0, 0, 0, 0, 0, 0, 0, 0, 0, 0, 0, 0, 0, 0, 0, 0, 0, 0, 0, 0, 0, 0, 0, 0, 0, 0, 0, 0, 0, 0, 0],
    [0, 0, 0, 0, 0, 0, 0, 0, 0, 0, 0, 0, 0, 0, 0, 0, 0, 0, 0, 0, 0, 0, 0, 0, 0, 0, 0, 0, 0, 0, 0, 0],
    [0, 0, 0, 0, 0, 0, 0, 0, 0, 0, 0, 0, 0, 0, 0, 0, 0, 0, 0, 0, 0, 0, 0, 0, 0, 0, 0, 0, 0, 0, 0, 0],
    [0, 0, 0, 0, 0, 0, 0, 0, 0, 0, 0, 0, 0, 0, 0, 0, 0, 0, 0, 0, 0, 0, 0, 0, 0, 0, 0, 0, 0, 0, 0, 0],
    [0, 0, 0, 0, 0, 0, 0, 0, 0, 0, 0, 0, 0, 0, 0, 0, 0, 0, 0, 0, 0, 0, 0, 0, 0, 0, 0, 0, 0, 0, 0, 0],
    [0, 0, 0, 0, 0, 0, 0, 0, 0, 0, 0, 0, 0, 0, 0, 0, 0, 0, 0, 0, 0, 0, 0, 0, 0, 0, 0, 0, 0, 0, 0, 0],
    [0, 0, 0, 0, 0, 0, 0, 0, 0, 0, 0, 0, 0, 0, 0, 0, 0, 0, 0, 0, 0, 0, 0, 0, 0, 0, 0, 0, 0, 0, 0, 0],
    [0, 0, 0, 0, 0, 0, 0, 0, 0, 0, 0, 0, 0, 0, 0, 0, 0, 0, 0, 0, 0, 0, 0, 0, 0, 0, 0, 0, 0, 0, 0, 0],
    [0, 0, 0, 0, 0, 0, 0, 0, 0, 0, 0, 0, 0, 0, 0, 0, 0, 0, 0, 0, 0, 0, 0, 0, 0, 0, 0, 0, 0, 0, 0, 0],
    [0, 0, 0, 0, 0, 0, 0, 0, 0, 0, 0, 0, 0, 0, 0, 0, 0, 0, 0, 0, 0, 0, 0, 0, 0, 0, 0, 0, 0, 0, 0, 0],
    [0, 0, 0, 0, 0, 0, 0, 0, 0, 0, 0, 0, 0, 0, 0, 0, 0, 0, 0, 0, 0, 0, 0, 0, 0, 0, 0, 0, 0, 0, 0, 0],
    [0, 0, 0, 0, 0, 0, 0, 0, 0, 0, 0, 0, 0, 0, 0, 0, 0, 0, 0, 0, 0, 0, 0, 0, 0, 0, 0, 0, 0, 0, 0, 0],
    [0, 0, 0, 0, 0, 0, 0, 0, 0, 0, 0, 0, 0, 0, 0, 0, 0, 0, 0, 0, 0, 0, 0, 0, 0, 0, 0, 0, 0, 0, 0, 0],
    [0, 0, 0, 0, 0, 0, 0, 0, 0, 0, 0, 0, 0, 0, 0, 0, 0, 0, 0, 0, 0, 0, 0, 0, 0, 0, 0, 0, 0, 0, 0, 0],
    [0, 0, 0, 0, 0, 0, 0, 0, 0, 0, 0, 0, 0, 0, 0, 0, 0, 0, 0, 0, 0, 0, 0, 0, 0, 0, 0, 0, 0, 0, 0, 0],
    [0, 0, 0, 0, 0, 0, 0, 0, 0, 0, 0, 0, 0, 0, 0, 0, 0, 0, 0, 0, 0, 0, 0, 0, 0, 0, 0, 0, 0, 0, 0, 0],
    [0, 0, 0, 0, 0, 0, 0, 0, 0, 0, 0, 0, 0, 0, 0, 0, 0, 0, 0, 0, 0, 0, 0, 0, 0, 0, 0, 0, 0, 0, 0, 0],
    [0, 0, 0, 0, 0, 0, 0, 0, 0, 0, 0, 0, 0, 0, 0, 0, 0, 0, 0, 0, 0, 0, 0, 0, 0, 0, 0, 0, 0, 0, 0, 0],
    [0, 0, 0, 0, 0, 0, 0, 0, 0, 0, 0, 0, 0, 0, 0, 0, 0, 0, 0, 0, 0, 0, 0, 0, 0, 0, 0, 0, 0, 0, 0, 0],
    [0, 0, 0, 0, 0, 0, 0, 0, 0, 0, 0, 0, 0, 0, 0, 0, 0, 0, 0, 0, 0, 0, 0, 0, 0, 0, 0, 0, 0, 0, 0, 0],
    [0, 0, 0, 0, 0, 0, 0, 0, 0, 0, 0, 0, 0, 0, 0, 0, 0, 0, 0, 0, 0, 0, 0, 0, 0, 0, 0, 0, 0, 0, 0, 0],
    [0, 0, 0, 0, 0, 0, 0, 0, 0, 0, 0, 0, 0, 0, 0, 0, 0, 0, 0, 0, 0, 0, 0, 0, 0, 0, 0, 0, 0, 0, 0, 0],
    [0, 0, 0, 0, 0, 0, 0, 0, 0, 0, 0, 0, 0, 0, 0, 0, 0, 0, 0, 0, 0, 0, 0, 0, 0, 0, 0, 0, 0, 0, 0, 0],
    [0, 0, 0, 0, 0, 0, 0, 0, 0, 0, 0, 0, 0, 0, 0, 0, 0, 0, 0, 0, 0, 0, 0, 0, 0, 0, 0, 0, 0, 0, 0, 0],
    [0, 0, 0, 0, 0, 0, 0, 0, 0, 0, 0, 0, 0, 0, 0, 0, 0, 0, 0, 0, 0, 0, 0, 0, 0, 0, 0, 0, 0, 0, 0, 0],
    [0, 0, 0, 0, 0, 0, 0, 0, 0, 0, 0, 0, 0, 0, 0, 0, 0, 0, 0, 0, 0, 0, 0, 0, 0, 0, 0, 0, 0, 0, 0, 0]
  ]
}